##############################################################################
#S                                                                           #
#                                                                            #
#                                                                            #
#                                                                            #
#                                                                            #
#                                                                            #
#                                                                            #
########################################################                     #
#                                                                            #
#                                                                            #
#                                                                            #
#                                                                            #
#                                                                            #
#                                                                            #
#                                                                            #
#                                                                            #
#                                                                            #
#                                      F                                     #
#                                                                            #
#                                                                            #
#                                                                            #
#                                                                            #
#                                                                            #
#                                                                            #
#                                                                            #
#                                                                            #
#                                                                            #
#                                                                            #
#                                                                            #
#                                                                            #
#                                                                            #
##############################################################################
